0000000000000000
0000000000000000
0000002220000000
0000241116220000
0003111111110000
0004111111110000
0031111111110000
0031111111110000
0031111111110000
0005111111110000
0003111111110000
0003111111110000
0000000000000000
0000000000000000